############################
######       ###############
######  g             ######
######         g      ######
#######   #   g       ######
###########           ######
############################